2222222222000000000000000000000000000000000000000000000000000000000000000000000000000000000000000000000000000000000000000000000000000000000000000000000022222222222222220
2222222222000000000000000000000000000000000000000000000000000000000000000000000000000000000000000000000000000000000000000000000000000000000000000000000022222222222222220
2222222222000000000000000000000000000000000000000000000000000000000000000000000000000000000000000000000000000000000000000000000000000000000000000000000022222222222222220
2222222222000000000000000000000000000000000000000000000000000000000000000000000000000000000000000000000000000000000000000000000000000000000000000000000022222222222222220
2222222222000000000000000000000000000000000000000000000000000000000000000000000000000000000000000000000000000000000000000000000000000000000000000000000002222222222222220
2222222222000000000000000000000000000000000000000000000000000000000000000000000000000000000000000000000000000000000000000000000000000000000000000000000002222222222222220
2222222220000000000000000000000000000000000000000000000000000000000000000000000000000000000000000000000000000000000000000000000000000000000000000000000000222222222222220
2222222220000000000000000000000000000000000000000000000000000000000000000000000000000000000000000000000000000000000000000000000000000000000000000000000000222222222222220
2222222220000000000000000000000000000000000000000000000000000000000000000000000000000000000000000000000000000000000000000000000000000000000000000000000000222222222222220
2222222220000000000000000000000000000000000000000000000000000000000000000000000000000000000000000000000000000000000000000000000000000000000000000000000000202222222222220
2222222220000000000000000000000000000000000000000000000000000000000000000000000000000000000000000000000000000000000000000000000000000000000000000000000000202222222222220
2222222220000000000000000000000000000000000000000000000000000000000000000000000000000000000000000000000000000000000000000000000000000000000000000000000000000222222222220
2222222200000000000000000000000000000000000000000000000000000000000000000000000000000000000000000000000000000000000000000000000000000000000000000000000000000222222222220
2222222200000000000000000000000000000000000000000000000000000000000000000000000000000000000000000000000000000000000000000000000000000000000000000000000000000022222222220
2222222200000000000000000000000000000000000000000000000000000000000000000000000000000000000000000000000000000000000000000000000000000000000000000000000000000022222222220
2222222200000000000000000000000000000000000000000000000000000000000000000000000300000000000000030000000000000000000000000000000000000000000000000000000000000022222222220
2222222200000000000000000000000000000000000000000000000000000000000000000000000333000033300003330000000000000000000000000000000000000000000000000000000000000022222222220
2222222200000000000000000000000000000000000000000000000000000000000000000000000333000333300003330000000000000000000000000000000000000000000000000000000000000022222222220
2222222200000000000000000000000000000000000000000000000000000000000000000000000033000000300003300000000000000000000000000000000000000000000000000000000000000022222222220
2222222200000000000000000000000000000000000000000000000000000000000000000000000033000000300003300000000000000000000000000000000000000000000000000000000000000020222222220
2222222200000000000000000000000000000000000000000000000000000000000000000000000033330000300003300000000000000000000000000000000000000000000000000000000000000020222222220
2222222200000000000000000000000000000000000000000000000000000000000000000000000033000000300003300000000000000000000000000000000000000000000000000000000000000000222222220
2222222200000000000000000000000000000000000000000000000000000000000000000000000033000000330033300000000000000000000000000000000000000000000000000000000000000000022222220
2222222200000000000000000000000000000000000000000000000000000000000000000000000033000033300003300000000000000000000000000000000000000000000000000000000000000000022222220
2222222200000000000000000000000000000000000000000000000000000000000000000000000033000000300003300000000000000000000000000000000000000000000000000000000000000000022222220
2222222200000000000000000000000000000000000000000000000000000000000000000000000033000000300003300000000000000000000000000000000000000000000000000000000000000000022222220
2222222200000000000000000000000000000000000000000000000000000000000000000000000033330000300003300000000000000000000000000000000000000000000000000000000000000000002222220
2222220200000000000000000000000000000000000000000000000000000000000000000000000033000000300003300000000000000000000000000000000000000000000000000000000000000000002222220
2222220200000000000000000000000000000000000000000000000000000000000000000000000033000000300003300000000000000000000000000000000000000000000000000000000000000000002222220
2222220000000000000000000000000000000000000000000000000000000000000000000000000033000033300003300000000000000000000000000000000000000030000000000000000000000000002222220
2222220000000000000000000000000000000000000000000000000000000000000000000000000033000000300003300000000000000000000000000000000000000000000000000000000000000000002222220
2222200000000000000000000000000000000000000000000000000000000000000000000000000033000000300003300000000000000000000000000000000000000000000000000000000000000000000222220
2222200000000000000000000000000000000000000000000000000000000000000000000000000033330000330003300000000000000000000000000000000000030000000000000000000000000000000222220
2222200000000000000000000000000000000000000000000000000000000000000000000000000033000000300003300000000000000000000000000000000000000000000000000000000000000000000222220
2222200000000000000000000000000000000000000000000000000000000000000000000000000033000000300003300000000000000000000000000000000000000000000000000000000000000000000222220
2220000000000000000000000000000000000000000000000000000000000000000000000000000033000033300003300000000000000000000000000000000003000000000000000000000000000000044222220
2000000000000000000000000000000000000000000000000000000000000000000000000000000033000000300003300000000000000000000000000000000000000000000000000000000000000004444422220
2000000000000000000000000000000000000000000000000000000000000000000000000000000033000000300003300000000000000000000000000000000000000000000000000000000000444444444422220
2000000000000000000000000000000000000000000000000000000000000000000000000000000333330000300003330000000000000000000000000000003300000000000000000000000044444444444422220
4444444444444444000000000000000000000000000000000000000000000000000000000000000333000000300333330000000000000000000000000000000000000000000000000000004444444444444442220
4444444444444444444444440000000000000000000000000000000000000000000000000000000000000000300000000000000000000000000000000000000000000000000000000004444444444444444442220
4444444444444444444444444444444444400004444440000040000000000000000000000000000000000033300000000004444000000000000000000000000000330000000000000044444444444444444442220
4444444444004444444444444444444444400004444440000044004440000000000444444444442222222222222222222444444444444000000000000000000000000000000000044444444444444444444442220
4444444444000004444444444444444444400004444440000044004444444444444444444444442222222222222222222444444444444444444444000000033300000000000000044444444444444444444442220
4444444444000000444444444444444444400004444440000044004444444444444444444444442222222222222222222444444444444444444444444444000000000000000000044444444444444444444422220
4444444444444000444444444444444444400004444440000044004444444444444444444444442222222222222222222444444444444444444444444444000000000000000000044444444444444444444222220
4444444444444444444444444444444444400004444440000044004444444444444444444444422222222222222222222244444444444444444444444444000000000000000000044444444444444444442222220
4444444444444444444444444444444444422224444442222244224444444444444444444444422222222222222222222244444444444444444444444444222222222222222222244444444444444422222222220
4444444444444444444444444444444444422224444442222244224444444444444444444444422222222222222222222244444444444444444444444444222222222222222222244444444444422222222244440
0000000000000000000000000000000000000000000000000000000000000000000000000000000000000000000000000000000000000000000000000000000000000000000000000000000000000000000000000
