00000000000000000000000000000000000000000000000000
00000000000000000000000000000000000000000000000000
00000000000000000000000000000000000000000000000000
00000000000000000000000000000000000000000000000000
00000000000000000000000000000000000000000000000000
00000000000000000000000000000000000000000000000000
00000000000000000000000000000000000000000000000000
00000000000000000000000000000000000000000000000000
00000000000000000000000000000000000000000000000000
00000000000000000000000000000000000000000010000000
00000000000000000000000000000000000000000010000000
00000000000000000000000000000000000000000110000000
00000000000000000000000000000000000000000110000000
00000000000000000000000000000000000000000111000000
00000000000000000000000000000000000000000111000000
00000000000000000000000000000000000000000111100000
00000000000000000000000000000000000000000111110000
00000000000000000000000000000000000000001111110000
00000000000000000000000000000000000000001111110000
00000000000000000000000000000000000000011111110000
00000000000000000000000000000000000000111111111000
00000000000000000000000000000000000000000040000000
00000000000000000000000000000000000000000040000000
00000000000000000000000000000000000000000040000000
00000000000033300000000000000000000000000000000000
00000000003333300000000000000000000000000000000000
00000000033333333000000000000000000000000000000000
00000000033333333000000000000000000000000000000000
00000000333333333000000000000000000000000000000000
00000000333333333030000000000000000000000000000000
00000000333333333330000000000000000000000000000000
00000000333333333330000000000000000000000000000000
00000000333333330000000000000000000000000000000000
00000000033000000000000000000000000000000000000000
00000000000000000000000000000000000000000000000000
00000000000000000000000000000000000000000000000000
00000000000000000000000000000000000000000000000000
00000000000000000000000000000000000000000000000000
00000000000000000000000000000000000000000000000000
00000000000000000000000000000000000000000000000000
00000000000000000000000000000000000000000000000000
00000000000000000000000000000000000000000000000000
00000000000000000000000000000000000000000000000000
00000000000000000000000000000000000000000000000000
00000000000000000000000000000000000000000000000000
00000000000000000000000000000000000000000000000000
00000000000000000000000000000000000000000000000000
00000000000000000000000000000000000000000000000000
00000000000000000000000000000000000000000000000000
00000000000000000000000000000000000000000000000000
