00000000000000000000000000000000000000000000000000
00000000000000000000000000000000000000000000000000
00030003000000000000000000000000000000000000000000
00030003000300000000000000000000000000000000000000
00030003000000000000000000000000000000000000000000
00033333000300000000000000000000000000000000000000
00030003000300000000000000000000000000000000000000
00030003000300000000000000000000000000000000000000
00030003000300000000000000000000000000000000000000
00030003000303000000000000000000000000000000000000
00000000000003000000000000000000000000000000000000
00000000000000000000000000000000000000000000000000
00030003033030033033303333303300000000000000000000
00030303030030030030303030303000000000000000000000
00030303033030030030303030303300000000000000000000
00030303030030030030303030303000000000000000000000
00033333033033033033303000303300000000000000000000
00000000000000000000000000000000000000000000000000
00000000000000000000000000000000000000000000000000
00000000000000000000000000000000000000000000000000
00000000000033000000000000000000000000000000000000
00000000003333330000000000000000000000000000000000
00000000033333330000000000000000000000000000000000
00000003333333333300000000000000000000004444400000
00000003333300033330000000000000000044444444444000
00000333330000033330000000000000004444444444444400
00000333300000000330000000000000044444222244444440
00003333300000000330000000000000444422222222222440
00003333000000000330000000000000444222222222222440
00003333000000000300000000000000444222222222222220
00000333000000000000000000000000222222222222222220
00000333000000000000000000000000222222222222222200
00000333000000003333333330000000222222222222222200
00000033300333333333333000000000022222222222202200
00000033333333333333300000000000002222222222200200
00000003333333333300000000000000002222222222000200
00000000000000000000000000000000000222222222000000
00000000000000000000000000000000000002222222000000
00000000000000000000000000000000000000222220000000
00000000000000000000000000000000000000222200000000
00000000000000000000000000000000000000222200000000
00000000000000000000000000000000000000222200000000
00000000000000000000000000000000000000022200000000
00000000000000000000000000000000000000002200000000
00000000000000000000000000000000000000000200000000
00000000000000000000000000000000000000000200000000
00000000000000000000000000000000000000000000000000
00000000000000000000000000000000000000000000000000
00000000000000000000000000000000000000000000000000
00000000000000000000000000000000000000000000000000
