2000000000000000000000000000000000000000000000000000000000000000000000
2000000000000000000000000000000000000000000000000000000000000000000000
2000000000000000000000000000000000000000000000000000000000000000000000
2000000000000000000000000000000000000000000000000000000000000000000000
2000000000000000000000000000000000005500000000000000000000000000000000
2000000000000000000000000000000000050050000000000000000000000000000000
2000000000000000000000000000000000500005000000000000000000000000000000
2000000000000000000000000000000005500005500000000000000000000000000000
2000000000000000000000000000000050500005050000000000000000000000000000
2000000000000000000000000000000500500005005000000000000000000000000000
2000000000000000000000000000005000500005000500000000000000000000000000
2000000000000000000000000000050000500005000050000000000000000000000000
2000000000000000000000000000555555555555555555000000000000000000000000
2000000000000000000000000000050000000005000050000000000000000000000000
2000000000000000000000000000050000000005000050000000000000000000000000
2000000000000000000000000000050000000005000050000000000000000000000000
2000000000000000000000000000050000000005005050000000000000000000000000
2000000000000000000000000000050000000005505050000000000000000000000000
2000000000000000000000000000050000050555005050000000000000000000000000
2000000000000000000000000550050005550500005050055000000000000000000000
2000000000000000000000005005050000550500055050500500000000000000000000
2000000000000000000000050000555500550500005055000050000000000000005500
2000000000000000000000500000050000500000005050000005000000000000050050
2000000000000000000005555555550000500005005055555555500000000000500000
2000000000000000000000500000050055505555005050000005000000000005000000
2000000000000000000000500000055050005000055050000005000000000055555550
2000000000000000000000500000050050005000005050000005000000000005000000
2000000000000000000000500050050050005000005050000005000000000005000000
2000000000000000000000505050555050005000055050000005000000000005000000
2000000000000000000000005050000050005000005000000000000000000005000000
2000000000000000000000005050000050005000005000000000000055500005000000
2000000000000000000022222222222222222222222222222222222222222222222220
2000000000000444444222222222222222222222222222222222222222222222222220
2000000004444444444222222222222222222222222222222222222222222222222220
2000044444444444444222222222222222222222222222222222222222222222222220
2444444444444444444222222222222222222222222222222222222222222222222220
2444444444444444442222222222222222222222222222222222222222222222222220
2444444444444444442222222222222222222222222222222222222222222222222220
2444444444444444442222222222222222222222222222222222222222222222222220
0000000000000000000000000000000000000000000000000000000000000000000000
