0000000000000000000000000000000000000000000000000000000000000000000000
0000000000000000000000000000000000000000000000000000000000000000000000
0000000000000000000000000000000000000000000000000000000000000000000000
0000000000000000000000000000000000000000000000000000000000000000000000
0000000000000000000000000000000000000000000000000000000000000000000000
0000000000000000000000000000000000005500000000000000000000000000000000
0000000000000000000000000000000000055550000000000000000000000000000000
0000000000000000000000000000000000055550000000000000000000000000000000
0000000000000000000000000000000005055550500000000000000000000000000000
0000000000000000000000000000000055055550550000000000000000000000000000
0000000000000000000000000000000555055550555000000000000000000000000000
0000000000000000000000000000005555055550555500000000000000000000000000
0000000000000000000000000000000000000000000000000000000000000000000000
0000000000000000000000000000005555555550555500000000000000000000000000
0000000000000000000000000000005555555050505500000000000000000000000000
0000000000000000000000000000005555555550555500000000000000000000000000
0000000000000000000000000000005505555550550500000000000000000000000000
0000000000000000000000000000005555555550050500000000000000000000000000
0000000000000000000000000000005555505000550500000000000000000000000000
0000000000000000000000000000005550005055550500000000000000000000000000
0000000000000000000000000550005555005050500500055000000000000000000000
0000000000000000000000000550000005005055550500055000000000000000000000
0000000000000000000000055555505555055555550505555550000000000000005500
0000000000000000000000000000005555055550550500000000000000000000055550
0000000000000000000000055555505500050000550505555550000000000000555550
0000000000000000000000055555500505550555500505555550000000000000000000
0000000000000000000000055555505505550555550505555550000000000000555550
0000000000000000000000055555505505550555550505555550000000000000555550
0000000000000000000000055555500505550555500505555550000000000000555550
0000000000000000000000555555555505550555550555555555000000000000555550
0000000000000000000000555555555505550555550555555555000000000000555550
0000000000000000000000000000000000000000000000000000000000000000000000
0000000000000000000000000000000000000000000000000000000000000000000000
0000000000000000000000000000000000000000000000000000000000000000000000
0000000000000000000000000000000000000000000000000000000000000000000000
0000000000000000000000000000000000000000000000000000000000000000000000
0000000000000000000000000000000000000000000000000000000000000000000000
0000000000000000000000000000000000000000000000000000000000000000000000
0000000000000000000000000000000000000000000000000000000000000000000000
0000000000000000000000000000000000000000000000000000000000000000000000
