300000000000000000000000000030
300000000000000000000000000030
300000000000000000000000000030
300000000000000000000000000030
300000000000000000000000000030
300000000000000000000000000030
300000000000000000000000000030
300000000000000000000000000030
300000000000000000000000000030
300000000000000000000000000030
333333330033333333333333333330
333333330033333333333333333330
330000030030000000000000000330
330000030030000000000000000330
330003030030000000000000000330
330003030033333033333333003330
333303030003000000300000000330
330003030003000000300000000330
330003030003000000300000000330
330033033003000003300000000330
330003033003000003300000000330
333003033003300003300000000330
330003033003330003300000000330
330003033000300033300000000330
330333033000300333300333333330
330003033000300003300000000330
330003033000330003300000000330
333003033300300003300000000330
330003033300300003300000000330
330003033300300303300000000330
330333033300300303333333003330
330003033300330303333300000330
330003033300300303300000000330
333003033303300303300000000330
330000000000330303300000000330
330000000000000333300000000330
333333000000000333300000000330
333333333333333333330033333330
333333333333333333330033333330
333333333333333333330033333330
330000000000000000000000000330
330000000000000000000000000330
330000000000000000000000000330
333333333333300033333333333330
330000000000300030000000000330
330000000000300030000000000330
330000000000300030000000000330
330000000000300030000000000330
333333333333300033330003333330
333333333333000300000000000330
330000000033000300000000000330
330000000033000300000000000330
330000000033000300000000000330
330000000030003000000000000330
330000000030003000000000000330
330000000030003000000000000330
330000000030003000000000000330
333333333333000300000000000330
333333333333000300000000000330
330000000033000330000000000330
330000000033000300000000000330
330000000033000300000000000330
330000000033000030000000000330
330000000033300030000000000330
330000000033300030000000000330
333333333333300030000000000330
333333333333300030000000000330
330000000033300030000000000330
330000000033300030000000000330
330000000033300000000000000330
330000000033300000000000000330
333333333333333333333333333330
333333333333333333333333333330
333333333333333333333333333330
000000000000000000000000000000
