000000000000000000000000000000
000000000000000000000000000000
000000000000000000000000000000
000000000000000000000000000000
000000000000000000000000000000
000000000000000000000000000000
000000000000000000000000000000
000000000000000000000000000000
330033003300330033003300330030
333333333333333333333333333330
000000003300000000000000000000
000000003300000000000000000000
003333303303333333333333333000
003333303303333333333333333000
003330303303333333333333333000
003330303300000300000000333000
000030303330333333033333333000
003330303330333333033333333000
003330303330333333033333333000
003300300330333330033333333000
003330300330333330033333333000
000330300330033330033333333000
003330300330003330033333333000
003330300333033300033333333000
003000300333033000033000000000
003330300333033330033333333000
003330300333003330033333333000
000330300033033330033333333000
003330300033033330033333333000
003330300033033030033333333000
003000300033033030000000330000
003330300033003030033333333000
003330300033033030033333333000
000330300030033030033333333000
003333333333003030033333333000
003333333333333000033333333000
000000333333333000033333333000
000000000000000000003300000000
000000000000000000003300000000
000000000000000000003300000000
003333333333333333333333333000
003333333333333333333333333000
003333333333333333333333333000
000000000000033300000000000000
003333333333033303333333333000
003333333333033303333333333000
003333333333033303333333333000
003333333333033303333333333000
000000000000033300003330000000
000000000000333033333333333000
003333333300333033333333333000
003333333300333033333333333000
003333333300333033333333333000
003333333303330333333333333000
003333333303330333333333333000
003333333303330333333333333000
003333333303330333333333333000
000000000000333033333333333000
000000000000333033333333333000
003333333300333003333333333000
003333333300333033333333333000
003333333300333033333333333000
003333333300333303333333333000
003333333300033303333333333000
003333333300033303333333333000
000000000000033303333333333000
000000000000033303333333333000
003333333300033303333333333000
003333333300033303333333333000
003333333300033333333333333000
003333333300033333333333333000
000000000000000000000000000000
000000000000000000000000000000
000000000000000000000000000000
000000000000000000000000000000
