555555555555555555555555555550
555555555555555555555555555550
550000000000000000000000000550
550000000000000000000000000550
550000000000000000000000000550
550000000000000000000000000550
550000000000000000000000000550
550000000000000000000000000550
550055555555555555555555555550
550055555555555555555555555550
550000000005000000000000000550
550000000005000000000000000550
550000000005000000000000000550
550000000005000000000000000550
550000000005000000000000000550
550000000005000000000000000550
550000000005000000000000000550
550000000005000000000000000550
550000000005000000000000000550
555555555505055555555555500550
555555555505055555555555500550
550000000005055000000000000550
550000000005055000000000000550
550000000000055000000000000550
550000000000055000000000000550
555555555555555005555555555550
555555555555555005555555555550
550000000000000000000000000550
550000000000000000000000000550
550000000000000000000000000550
550000000000000000000000000550
550000000000000000000000000550
550000000000000000000000000550
550000000000000000000000000550
550000000000000000000000000550
550055555555555555555555555550
550055555555555555555555555550
550000000000000000000000000550
550000000000000000000000000550
550000000000000000000000000550
550000000000000000000000000550
550000000000000000000000000550
555555555555555555555550055550
555555555555555555555550055550
550000000000000000000000000550
550000000000000000000000000550
550000000000000000000000000550
555005555555555555555555555550
555005555555555555555555555550
550005555555500000000000000550
550005555555500000000000000550
550005555550000000000000000550
550005555550000000000000000550
550005555000000000000000000550
550005555000000555555000000550
550005500000000555555000000550
550005500000055555055500000550
550000000000055550055500000550
550000000005555550055500000550
550000000005555550055550000550
550000000555555550055550000550
550000000555555550555550000550
550000055555555550055550000550
550000055555555550055550000550
550005555555555550055550000550
555555555555555550055555055550
555555555555555555055555055550
550000000000000000000000000550
550000000000000000000000000550
550000000000000000000000000550
550005555555555555555555555550
550005555555555555555555555550
550000000000000000000000000550
550000000000000000000000000550
550000000000000000000000000550
550000000000000000000000000550
550000000000000000000000000550
550000000000000000000000000550
555555555555555555555555500550
555555555555555555555555500550
550000000000000000000000000550
550000000000000000000000000550
550000000000000000000000000550
550000000000000000000000000550
550000000000000000000000000550
550000000000000000000000000550
550000000000000000000000000550
550000000000000000000000000550
550000000000000000000000000550
550000000000000000000000000550
550000000000000000000000000550
550000000000000000000000000550
550000000000000000000000000550
550000000000000000000000000550
550000000000000000000000000550
555555555555555555555555555550
555555555555555555555555555550
555555555555555555555555555550
555555555555555555555555555550
000000000000000000000000000000
