000000000000000000000000000000
000000000000000000000000000000
005555555555555555555555555000
005555555555555550555555555000
005555555555555555555555555000
005555550555555555555555555000
005555555555555555555550555000
005555555555555555555555555000
005500000000000000000000000000
005500000000000000000000000000
005555555550555555555555555000
005555555550555555555055555000
005550555550555555555555555000
005555555550555555555555555000
005555555550555555555555555000
005555555550555505555555555000
005505555550555555555555555000
005555555550555555555555555000
005555555550555555555555555000
000000000050500000000000055000
000000000050500000000000055000
005555555550500555555555555000
005555555550500555550555555000
005555555555500555555555505000
005555555555500555555555555000
000000000000000550000000000000
000000000000000550000000000000
005555555555555555555555555000
005550555555555555555505555000
005555555555555555555555555000
005555555555055555555555555000
005555555555555555555555555000
005555555555555555555555555000
000555555555555555555555555000
005555555555555555555555555000
005500000000000000000000000000
005500000000000000000000000000
005555555555555555555555555000
005555555555555555555055555000
005555555555555555555555555000
005550555555555555555555555000
005555555555555555555555555000
000000000000000000000005500000
000000000000000000000005500000
005555555555555555555550555000
000555555550555555555555555000
005555555555555555055555555000
000550000000000000000000000000
000550000000000000000000000000
005550000000055555555555555000
005550000000050555555555555000
005550000005555555555555555000
005550000005555555555555555000
005550000555555555555555555000
005550000555555000000555505000
005550055555555000000555555000
005550055555500000500055555000
005555555555500005500055555000
005555555550000000500055555000
005055555550000005500005555000
005555555000000005500005555000
005555555000000005000000555000
005555500000000005500005555000
005555500000000005000005555000
005550000000000005500005555000
000000000000000005500000500000
000000000000000000500000500000
005555555555555555555505555000
005555555555555055555555555000
005555555555555555555555555000
005550000000000000000000000000
005050000000000000000000000000
005555555550555555555555555000
005555555555555555550555555000
005555555555555555555555555000
005555555555055555555555505000
005555555555555555555555555000
005555555555555555555555555000
000000000000000000000000055000
000000000000000000000000055000
005555555555555555555555555000
005055555555555055555555555000
005555555555555555555055505000
005555555555555555555555555000
005555555555555555555555555000
005555555555555550555555555000
005555550555555555555555555000
005555555555555555555555555000
005555555555505555555550555000
005555555555555555055555555000
005555555555555555555555555000
005555555555555555555555555000
005550555555555555555555055000
005555555555555555555555555000
005555555555555555555555555000
000000000000000000000000000000
000000000000000000000000000000
000000000000000000000000000000
000000000000000000000000000000
000000000000000000000000000000
