000000000000000000000000000000
000000000000000000000000000000
000060000000000000000000600000
000000000000000008000000000000
000000000000000000000000000000
000000008000000000000000000000
000000000000000000000008000000
000000500200200200200200010000
000000000000000000000000000000
000000000000000000000000000000
000000000600000000000000000000
000000000000000000000800000000
000008000000000000000000000000
000000000000000b00000000000000
000b00000000000000000000000000
00000000b0000b00800000b0000000
0000800000000000000b0000000000
000000000000b00000000000000000
002222222200022222222222200000
000000000000b00000000000000000
000000000000000000000000000000
000000006000b00006000000000000
000007000000000000008000000000
000000000003000000000000080000
002000000003000000500000000000
000000000000000000000000000000
000000000000000000000000000000
000000000000000000000000000000
000008000000000000000080000000
000000000000000000000000000000
000000000000800000000000007000
000000000000000000000000000000
000000000000000000000000000000
0080b000b000b000b000b000b00000
000022222222222222222222222000
000000000000000000000000000000
000000000000000000000000000000
000000000000000000000000000000
000000000000000000000800000000
000000000000000000000000000000
000b08b00b00b0b000b0b000000000
002222222222222222222220022000
000000000000000000000000000000
000000000000000000000000000000
000600000000000000000008060000
008000000008007000000000000000
000000500000000000800005000000
000000000000000000000000000000
000000000000000000000000000000
000000000000000000000000600000
000000000000008000000000000000
000000000000600000000000000000
0000000000000000b000b000000000
00000000000000b222222000000000
000000000000000000000000080000
000000000000b22000000200000000
000000000000000000700000000000
0000000000b2200000000000000000
000000000000000008b00020000000
00080000b22000000b000000000000
00000000000000000b200000000000
000000b22000000000000008000000
00000000000000000b000000000000
0000b2200000000000800000000000
002220000000000000b00002022000
000000000000000002000000000000
000000000000000000b00000000000
000600000000000000000080060000
000000000000000800000000000000
000000500000000000000000500000
000000000000000000000000000000
000800000000000000000000000000
000000000008000000000000000000
000000000000000000008000000000
000000000000000000000000000000
000000000000800000000000080000
0000b00b0b000b0b00b000b0b00000
002222222222222222222222200000
000000000000000000000000000000
000000000000000000000000000000
000000000000000000000000000000
000800000000000800000000000000
000000000000700000000800080000
000000b0b000000000000000000000
000000000000000000000000000000
0000b0000000000008000000000000
000000008000000000000000000000
000000000000000000000000000000
000000000000080000000008000000
0000b0b00b00000000800000000000
000000000000000000000000000000
00000000000b000000000000000000
00000800000000b0b00b00b08b0000
000000000000000000000000000000
002222222222222222222222222000
000000000000000000000000000000
000000000000000000000000000000
000000000000000000000000000000
000000000000000000000000000000
000000000000000000000000000000
