6666666666666666666666666666666666666666666666666666666666666666666666666660
6666666666666666666666666666666666666666666666666666666666666666666666666660
6666666666666660000000000666666666666666666666666666666666666666666666666660
6660000000000000000000000000000006666666666000000066666666666666666666666660
6600000000000000000000000000000000000000000000000006666666666666666666666660
6660000000000000000000000000000000000000000000000000000000066666666666666660
6660000000000000000000000000000000000000000000000000000000000000006666666660
6666660000000000000000000000000000000000000000000000000000000000006666666660
6666666660000666000000000000000000000000000000000000000000000000000666666660
6666666660000666666000000000000000000000006060000000000000000000000066666660
6666666660000666666600000000000000000000000000000000000000000000000066666660
6666666660000666666660000000000000000666600000000000000000000000000006666660
6666666660000666666666000000000000666666660000000000000000000000000006666660
6666660000000000666666000000000000666666666000000000000000000000000006666660
6666000000000000006666000000000000666666666000000000000000000000000000666660
6666000000000000006666600000000000000666666660000000000000000000000000666660
6660000000000000006666600000000000000006666666000000000000000000000000666660
6660000000000000000666000000000000000000666666660000000000000000000000666660
6660000000000000000666000000000000000000000666666000000000000000000000066660
6660000000000000000666000000000000000000000066666000000000000000000000066660
6660000000000000000666000000000000000000000006666666600000000000000000006660
6660000000000000000666000000000000000000000006666666660000000000000000000660
6660000000000000000666000000000000000000000000666666660000000000000000000660
6660000000000000006666000000000000000000000000066666660600000000000000000660
6660000000000000006666000000000000000000000000066666666660000000000000000660
6660000000000000006660000000000000000000000000006666666660000000000000000660
6660000000000000666600000000000000000000000000000666666660000000000000000660
6660000000000000666600000000000000000000000000000066666666000000000000000660
6660000000000000666000000000066666666000000000000066666666660000000000006660
6660000000000006666000000000666666666600000000000006666666660000000000006660
6660000000000006666000000006666666666666000000000000066666660000000000006660
6666000000000666666000000066666666666666600000000000060666666600000000006660
6666000000000666666000000666666666666666660000000000060666666600060000006660
6666600000006666666000000666666666666666660000000000060066666660666000066660
6666666666666666666000006666666666666666666000000000060066666660666600066660
6666666666666666666000006666666666666666666600000000000006666600666666666660
6666666666666666660000006666600666666666666660000000000000666600666666666660
6666666666666666600000006666600066666666666666000000000000666600006666666660
6666666600066666600000006666666066666666666666000000000000066660000066666660
6666666600666666600000006666666066666666666666000000000000006660000066666660
6666666000666666000000000666666006666666666666000000000000006666000006666660
6666666666666660000000000006666006666666666666000000000000000666600000666660
6666666666666600000000000006666666666606666666000000000000000666660000666660
6666666666666600000000000000666666666600066666000000000000000066660000066660
6666666666666000000000000000666666666600066666600000000000000066666600006660
6666666666660000000000000000666666666600066666660000000000000066666660006660
6666606666660000000000000000666666666660666666660000000000000066666660000660
6666606666600000000000000000066666666600666666660000000000000066666666600660
6666006666600000000000000000066666666666666666660000000000000066666666600660
6666006666600000000000000000000666666666666666600000000000000066666666600660
6666066666000000000000000000000000666666666666000000000000000006666666600660
6660666660000006000000000000000000066666666666000000000000000006666666000660
6666666660000006000000000000000000066666666660000000000000000006666666000660
6666666000000006000000000000000000000666666600000000000000000000666666000660
6666666000000066000000000000000000000000666600000000000000000000666660000660
6666660000000066000666660000000000000000066600000000000000000000660000000660
6666600000000066066666666660000000000000066600000000000000000000000000000660
6666600000000066066666666666600000000000066000000000000000000000000000000660
6666600000000066666660006666660000000000006000000000000000000000000000000660
6666000000006666666000000066666000000000006000000000000000000000000000000660
6666000000000066600000000006666066660000006660000000000000000000000000000660
6666000000000000000000000000666666000060606000000000000000000000000006600660
6666000000000000000000000000666660000000000000000000000000000000000006666660
6666600000000000000000000000000660000000000000000000000000000000000066666660
6666660000000000000000000000000666000000000000000000000000000000000066666660
6666666600000000000000060000000666000000000000000000000000000000000066666660
6666666666666000000006660000000666600000000000000000000000000000000066666660
6666666666666600000006600000000066660000000000000000000000000000000066666660
6666666666666600000666000000000066666000000000000000000000006060000666666660
6666660000000666666660000000000666666660000000000000000000000000000666666660
6660000000000006666000000000000666666666660000000000000000000000000666666660
6660000000000000000000000000000666666666666660000000000000000000006666666660
6660000000000000000000000000000666666666666666600000000000000000066666666660
6660000000000000000000000000006666666666666666666600000000000000666666666660
6660000000000000000000000000066666666666666666666666600000066666666666666660
6666000000000000000000000000666666666666666666666666666666666666666666666660
6666000000000000000000660066666666666666666666666666666666666666666666666660
6666666666000000000006666666666666666666666666666666666666666666666666666660
6666666666660000000066666666666666666666666666666666666666666666666666666660
6666666666666666666666666666666666666666666666666666666666666666666666666660
6666666666666666666666666666666666666666666666666666666666666666666666666660
6666666666666666666666666666666666666666666666666666666666666666666666666660
0000000000000000000000000000000000000000000000000000000000000000000000000000
