0000000000000000000000000000000000000000000000000000000000000000000000000000
0000000000000000000000000000000000000000000000000000000000000000000000000000
0000000000000000000000666000000000000000000000000000000000000000000000000000
0000000000000000000000066000000000000000000000000000000000000000000000000000
0000000000000000000000666666666000000000000000000000000000000000000000000000
0000000000000000000066666666666660000000000000000066660000000000000000000000
0000000000000000000066606600006666600000000000000666600000000000660000000000
0000000000000000000666000660000006666000000000006666000000000000660000000000
0000000000000000006600000666000000066600000000006666000000000000666000000000
0000000000000000000600000066600000000666000000066666000000000000666000000000
0000000000000000000000000006600000000066000000066666660000000000666000000000
0000000000000000000000000006660000000000000000666606666000000000666000000000
0000000000000000000000000000660066000000000006660000666600000006666000000000
0000000000000660000000000000066666000000000066600000066600000006666000000000
0000666000000660000000660006666000000000000666000000066600000066660000000000
0000066000000660000000066666600000000000000000000000006600000066660000000000
0000066600006660000000066666000000000000000000000000006660006666600000000000
0000006600006660000000666666000000000006000000000000006666666666600000000000
0000006660006666000000666666000000000066666000000000006666666666600000000000
0000000660066666600000006666600000006666660000000000006666666006600000000000
0000000660066666600000000066666000666666660000000000006666000006600000000000
0000000066066006600000000006666006666666600000000000006666000006600000000000
0000000066666006660000000000666066666660000000000000006660000000660000000000
0000000066666006660000000000666666666600000000000000006060000000660000000000
0000000006660006660000000000066666666000000000000000000000000000666000006000
0000000066600000660000000000066666660000000000000000000000000000666000006000
0000006666600000000000000000066666600000000000000000000000000000066600066600
0000066666660000000000000000006606000000000000000000000000000000006660666000
0006666606660000000000000000000000000000000000000000000000000000000666660000
0006666000660000000000000000000000000000000000000000000000000000000066660000
0006600000660000000000000000000000000000000000000000000000000000000666000000
0000000000660000000000000000000000000000000000000000000000000000000666000000
0000000000666000000000000000000000000000000000000000000000000000006660000000
0000000000060000000000000000000000000000000000000000000000000000000600000000
0000000000000000000000000000000000000000000000000000000000000000000000000000
0000000000000000000000000000000000000000000000000000000000000000000000000000
0000000000000000006600000000066000000000000000000000000000000000000000000000
0000000000000000066666000000066600000000000000000000000000000000660000000000
0000000066600000066666600000000600000000000000000000000000000006600000000000
0000000066000000006666660000000600000000000000000000000000000006600000000000
0000000666000000000006666000000660000000000000000000000000000000000000000000
0000000000000000000000666660000660000000000000000000000000006000000000000000
0000000000000000000000000660000000000060000000000000000000006000000000000000
0000000000000000000000000066000000000066600000000000000000066600000000600000
0000000000000000000000000006000000000066600000000000000006666000000006660000
0000000000000000000000000006000000000066600000000000000006660000000006660000
0000060000000000000000000006000000000006000000000000000006660000000006666000
0000060000000000000000000006600000000066000000006000000066600000000000066000
0000660000000000000000000000600000000000000000006660000666600000000000066000
0000660000000000000000000000666000000000000000066666600666000000000000066000
0000600000000000000000000000666660000000000000666666666666000000000000066000
0006600000000000000000000000066660000000000000066666666660000000000000600000
0000000000000000000000000000006660000000000000000066666660000000000000000000
0000000000000000000000000000006660006000000000000006666666000006000000000000
0000000000000000000000000000006666066666000000000000666666600006000000000000
0000000000000000000000000000000666666666000000000000066666600066006600000000
0000000000000000000000000000000666666600000000000000066666666666666000000000
0000000000000000000000000000000066666000000000000000006666666666666000000000
0000000000000000000000000000000066660000000000000000006666666666660000000000
0000000000000000000600000000000066660000000000000000000666666666600000000000
0000000000000000066600000000000000000000000000000000000066666660000000000000
0000000000000000066660000000000000660000000600000000000666666660000000000000
0000000000000000066660000000000006660000006600000000006666666600000000000000
0000000000000000006666000000000006600000006600000000066666666000000000000000
0000000000000000000666000000000000600000006600000000066666666600000000000000
0000000000000000000666600000000000600000006660000000066666066660000000000000
0000000000000000000660000000000000000000006660000000666666006660000000000000
0000000000000000000660066000000000000000006660000006666660000666000000000000
0000000000000000000000666600000000000000066660000006666660000666000000000000
0000006666066000000006666600000000000000066660000006666660000666600000000000
0006666660666660000006666660000000000000006660000066666600000666600000000000
0006666666666600000006666660000000000000000000000066666600000666600000000000
0006660666660000000066666666000000000000000000000066666000000666600000000000
0006660066600000000066606666000000000000000000000066660000000660000000000000
0006666666600000000666000666000000000000000000000000000000000000000000000000
0000666666660000000660000666000000000000000000000000000000000000000000000000
0000666666660000006660000600000000000000000000000000000000000000000000000000
0000000000666600006660000000000000000000000000000000000000000000000000000000
0000000000006666666600000000000000000000000000000000000000000000000000000000
0000000000000000000000000000000000000000000000000000000000000000000000000000
0000000000000000000000000000000000000000000000000000000000000000000000000000
0000000000000000000000000000000000000000000000000000000000000000000000000000
0000000000000000000000000000000000000000000000000000000000000000000000000000
