200000000000000000000000000000000000000000000000000000000000000000000000020
200000000000000000000000000000000000000000000000000000000000000000000000020
200000000000000000000000000000000000000000000000000000000000000000000000020
200000000000000000000000000000000000000000000000000000000000000000000000020
200000000000000000000000000000000000000000000000000000000000000000000000020
200000000000000000000000000000000000000000000000000000000000000000000000020
200000000000000000000000000000000000000000000000000000000000000000000000020
200000000000000000000000000000000000000000000000000000000000000000000000020
200000000000000000000000000000000000000000000000000000000000000000000000020
200000000000000000000000000000000000000444400000000000000000000000000000020
200000000000000000000000000000000000044444444000000000000000000000000000020
200000000000000000000000000000000044444444444400000000000000000000004444420
200440000000000000000000000000000444424444444440000000000000000044444444420
244444400000000000000000000000000422222442224444000000000000004444444444420
244224440000000000000000000000000002222222222244000000000004444444444422420
222222244000000000000000000000000002222222222220000000000004444422442222220
222222220000000000000000000000000002022222222200000000000000224222422222220
202222220000000000044444400000000002022222222200000000000000224222222222220
200222200000000004444444440000000000022222222000000000000000222222222222220
200222200000000004444444444400000000022222222444000000000000222222222222220
200222000000000002242442244440000000002222222424000000000000222222222222220
200222000000000002222222224220000000002222222222400000000000202222222222220
200022000000000000222222222200000000002222222222200000000000200222222222220
200022000000000000022222220000000000000222222222000000000000000222222222220
200002000000000000022222200000000000000222222220000000000000000222222222220
200002000000000000022222200000000000000222222200000000000000000022222222220
200000000000000000002222000000000000000022222200000000000000000002222222220
200000000000000000002220000000000000000022222200000000000000000002222222220
200000000000000000002200000000000000000022222000000000000000000002222222220
000000000000000000000000000000000000000000000000000000000000000000000000000
